Prof. Fee 2009 (Dub Taylor D. Mark Remix) - Patrick Lindsey
Helping Witness (Helly Larson Remix) - Klartraum
Berlin - Justin Berkovi & Sevington
The Tribe - Tim Engelhardt
Femur - Counrad
Crossing - Helly Larson
Dychotomie (Riccicomoto Bipolar Session) - Nadja Lind & Riccicomoto
Solid - Dimmish
Full Focus - Terje Saether
Magnetic Swift (Klartraum Dream Remix) - Helly Larson & Riccicomoto
Dreams - D. Diggler
Brotha Herve - Nadja Lind
Worthy of Me (Klartraum Remix) - Timmus
Wout 6 - Jonas Franzen
Immortal (feat. Hansekind) - Riccicomoto
Ball of Fur - G-Man & Nadja Lind
Melon Collie Dub (Shayde Remix) - Franksen
Days of Glory (Dub Session) - Riccicomoto
Voyage - Nadja Lind
Flamingo Park (Helly Larson Remix) - Helmut Ebritsch
Maurice - Andy Bach
Those Who Be Happy (Klartraum Remix) - Riccicomoto
Dub Terminal - Dave Marian
Amazonas Santiago (Riccicomoto Para Dub) - Klartraum
Smooth Bass Phunk - Helmut Ebritsch
Contra emozione (Helmut Ebritsch Club Remix) - Stefan Weise & i.qu
Behind Me (Riccicomoto Remix) - Weisses Licht
Last Lullaby (Nadja Lind Lucid Moment Remix) - Digital South
When We Get Started Here - Riccicomoto
Reflections - Brickman
